NO ./textures/North.xpm
SO ./textures/South.xpm
WE ./textures/West.xpm
EA ./textures/East.xpm

F 0,0,0
C 0,0,0

1111111111111
1000001000001
10000N0000001111
1000000000000001
1000000000001111
1000000000001
1000000000001
1000000000001
1000000000001
1000000000001
1000000000001
1000000000001
1111111111111
